ZZZZZZZZRZZZZZZFFZZZ
ZZZZFFFZRZZZZFFFFZZZ
ZZZFFFZZRZFFFFFZZZZZ
FFFFFFFFRFFFFFFFFZZZ
ZZFFFFFFRZZZFFFZZZZZ
ZZZFFFFZRZZFFFFZZZZZ
ZZZFFZZZRZZZZFFFFFZZ
ZZZFZRRRRZZFFFFFZZZZ
ZZZZZRZZZZFFFFZZZZZZ
ZZZZZRZZFFFFZZZZZZZZ
ZZZZZRZZZFFFFFFZZZZZ
ZZZZZRZZFFFFZZZZZZZZ
ZZZZZRZZZFFFFZZZZZZZ
ZZZZZRZZZZFFZZZZZZZZ
ZZZZZRZZZZFZZZZZZZZZ
